1111111111111111111111111111111111111111
1P0000000000000000000000000000000000C0E1
100000000000000000000000000000000000C001
100000000000000000000000000000000000C001
100000000000000000000000000000000000C001
100000000000000000000000000000000000C001
100000000000000000000000000000000000C001
100000000000000000000000000000000000C001
100000000000000000000000000000000000C001
100000000000000000000000000000000000C001
100001000100000000000000000000000000C001
1000011011011110100001000000000000000001
1000010101010010010010000000000000000001
1000010001011110001100000000000000000001
1000010001010010001100000000000000000001
1000010001010010010010000000000000000001
1000010001010010100001000000000000000001
1111111111111111111111111111111111111111