1111111111111111111111111111111111111111
1P0000000000000000000000000000000000C0E1
100000000000000000000000000000000000C001
100000000000000000000000000000000000C001
100000000000000000000000000000000000C001
100000000000000000000000000000000000C001
100000000000000000000000000000000000C001
100000000000000000000000000000000000C001
100000000000000000000000000000000000C001
100000000000000000000000000000000000C001
100001000100000000000000000000000000C001
100001101101111010000100000000000000C001
100001010101001001001000000000000000C001
100001000101111000110000000000000000C001
100001000101001000110000000000000000C001
100001000101001001001000000000000000C001
100001000101001010000100000000000000C001
100000000000000000000000000000000000C001
100000000000000000000000000000000000C001
100000000000000000000000000000000000C001
100000000000000000000000000000000000C001
100000000000000000000000000000000000C001
100000000000000000000000000000000000C001
100000000000000000000000000000000000C001
100000000000000000000000000000000000C001
100000000000000000000000000000000000C001
100000000000000000000000000000000000C001
100000000000000000000000000000000000C001
100000000000000000000000000000000000C001
100000000000000000000000000000000000C001
100000000000000000000000000000000000C001
100000000000000000000000000000000000C001
100000000000000000000000000000000000C001
100000000000000000000000000000000000C001
1111111111111111111111111111111111111111